11111111111111111111111111111111111111111111111111
10010000010000010000010000001000001000001000001001
10010000010000010000010060001000001000001000001001
11110010010010010010010000001001001001001001001111
10200010010010010010010000001001001001001001000701
10000010010010010010010000001001001001001001000001
11111110010010010010010055001001001001001001111111
10000000010010010010010050001001001001001000000001
10000000010010010010010050001001001001001000000001
10011111110010010010010050001001001001001111111001
10000000000010010010010000001001001001000000000001
10000000000010010010010000001001001001000000000001
11111111111110010010015550001001001001111111111111
10000000000000010010010000001001001000000000000001
10000000000000010010010000001001001000000000000001
10011111111111110010010000001001001111111111111001
10000000000000000010010000001001000000000000000001
10000000000000000010010055551001000000000000000001
11111111111111111110010000001001111111111111111111
10000000000000000000010000001000000000000000000001
10000000000000000000010000001000000000000000000001
10011111111111111111110000001111111111111111111001
10000550000000000000000000000000000000000000000001
10000000000555555500000000000000055500000000000001
10060000000000000000000070000000050000000000004001
10000000000550000000000000000000050000000500000001
10000055555555000000000000000000050000000500000001
10000000000000000000000000000000000000000500000001
10011111111111111111110000001111111111111111111001
10000000000000000000010000001000000000000000000001
10000000000000000000010000001000000000000000000001
11111111111111111110010000001001111111111111111111
10000000000000000010010000001001000000000000000001
10000000000000000010010000001001000000000000000001
10011111111111110010010055001001001111111111111001
10000000000000010010010005001001001000000000000001
10000000000000010010010005001001001000000000000001
11111111111110010010010055001001001001111111111111
10000000000010010010010000001001001001000000000001
10000000000010010010010000001001001001000000000001
10011111110010010010010000001001001001001111111001
10000000010010010010010000001001001001001000000001
10000000010010010010010005551001001001001000000001
11111110010010010010010000001001001001001001111111
10700010010010010010010000001001001001001001000001
10000010010010010010010000001001001001001001000301
11110010010010010010015500001001001001001001001111
10010000010000010000010006001000001000001000001001
10010000010000010000010000001000001000001000001001
11111111111111111111111111111111111111111111111111