11111111111111111111111111111111111111111111111111
12000000100100100110011001100110011001001001010401
10000000100001100110011001100110011001001000010111
11111100000011000000011000000110000001000000000001
10100000001110000000011000000110000001001111111001
10100000001000100110000001100000011001001000001001
10000000000000100110000001100000011000001001001001
10000000000000100000011000000110000000001001001001
11100001110011111100011000000110000001001001111001
10000111000000010110011001100110011001000000000001
11001110001110010110011001100110011001111000001111
10000010001010010000011000000110000001000000000001
10000010011011111111111111111111111111001111111001
10110010010010000000000000000000000001001001001001
11111610010010000000000000000000000001001001001001
11001110010010011111111111111111111001001000001001
10000100000010010000000000000000001001000000001001
10000000000010010000000000000000001001111100000001
10011111111110010011111111111111001001000000111111
10010000000010010000010000010001001001000000000001
10010000000010010000010000010161001001001111111001
10010011110010010010010010010111001001001001001001
10010010010010010010010010010001001001101001001001
11010011010010011110010010010001001001001007001001
11010010010010010010010010011101001001000000001001
10010010110010010010010010010701001001000000000001
10010010010010010010010010010001001001111111100111
10010011010010010010010010010111001001000000000001
10010010010010010010010010010001001001001111111001
10010010110000010010000010000011001111000001000001
10010010010000010010000010000001001001100011100001
10010011010010010011111111111111001001000110110001
10010000010010010000000000000000000001001100011001
10010000010010010000000000000000000001000000000001
10011111110010011111111111111111111001110000000001
10000000000010000000000000000000000001000000011111
10000000000010000000000000000000000001000111000001
11100111111111111111111111111111111111001111100001
10000000000000000000000000000001000000000111110001
10000000000000000000000000000001000000000011111001
10000011110010011111111111111111111111000111110001
10111000010010000000010000000100000000001111100001
10111000010010000000010000000100000000000111000001
10000001110010011111110011111110011111000000111111
10111070010010000000000000000000000001110000101001
10111000010010000000000000000000000001000100000001
10000011110010011111111111001111111001110100001101
10010000000110000000000100000010060001000100101001
10010000000010000000000100000010000001010100101031
11111111111111111111111111111111111111111111111111